___  ___  ___  ______  ___  
|  \/  | / _ \ | ___ \/ _ \ 
| .  . |/ /_\ \| |_/ / /_\ \
| |\/| ||  _  ||  __/|  _  |
| |  | || | | || |   | | | |
\_|  |_/\_| |_/\_|   \_| |_/
                            